3 13 31
###############################
#p  x 1 * *    *   *  * *     #
# # # #*# # #*#*# # # #*#*#*# #
#  f      ***  *      *   * * #
# # # # # #*# # #*#*# # # # #*#
# *          **  *  *   2     #
# # # # # # # # # #*# #*# # # #
#*  f      *  *      *        #
# # # # #*# # # #*#*# # # # # #
#*    **  *       *           #
# #*# # # # # # #*# #b# # # # #
#    **     *   *  *          #
###############################