2 13 31
###############################
#p     b* *    *   *  * * *   #
# # # # # # #*#*# # # #*#*#*# #
#   *  *f * *  *  5   *   * * #
# #b# #x# #*# # #*#*# # # # #*#
#f   s       **  *  *         #
# # # # # # # # # #*# #*# # # #
#*  *   s  *  *      *        #
# # # # #*# # # #*#*# # # # # #
#*    **  *    6  *           #
# #*# # # # # # #*# # # # # # #
#           *   *  *          #
###############################